{
  "level":2,
  "SQUARES_X":0,
  "SQUARES_Y":0,
  "terrain": {
    "SQUARES_X":25,
    "SQUARES_Y":20,
    "terrain":[
      [0,0,0,0,0,0,0,0,0,0,0,0,0,0,0,0,0,1,1,1,1,1,1,1,0],
      [1,1,1,1,1,1,1,1,1,1,1,1,1,1,0,0,0,1,0,0,0,0,0,1,0],
      [1,1,0,0,0,0,1,1,1,1,0,0,1,1,0,0,0,1,0,0,0,0,0,1,0],
      [1,1,0,0,0,0,1,1,1,1,0,0,1,1,0,0,0,1,0,0,0,0,0,1,0],
      [1,1,0,0,0,0,1,1,1,1,1,1,1,1,0,0,0,1,1,1,2,1,1,1,0],
      [1,1,0,2,2,2,2,2,2,2,2,2,2,2,2,2,2,2,2,1,2,1,0,0,0],
      [1,1,1,1,1,1,1,1,1,1,1,1,1,1,0,0,0,0,2,2,2,2,2,0,0],
      [1,1,1,1,1,1,1,1,1,1,1,1,1,1,0,0,0,0,0,0,0,0,2,0,0],
      [1,1,1,1,1,1,1,1,1,1,1,1,1,1,0,0,0,0,0,0,0,0,2,0,0],
      [0,0,0,0,0,0,0,0,0,0,0,0,0,0,0,0,0,0,0,0,0,0,2,0,0],
      [0,0,0,0,0,0,0,0,0,0,0,0,0,0,0,0,0,0,0,0,0,0,2,0,0],
      [0,0,0,0,0,0,0,2,2,2,2,2,2,0,0,0,0,0,0,0,0,0,2,0,0],
      [0,0,0,0,0,0,0,2,0,0,0,0,0,0,0,0,0,2,0,0,0,0,2,0,0],
      [0,0,0,0,2,2,2,2,0,0,0,0,0,0,0,0,0,2,0,0,0,0,2,0,0],
      [0,0,0,0,0,0,0,2,2,2,2,2,2,2,2,2,2,2,2,2,2,2,2,0,0],
      [0,0,0,0,0,0,0,2,1,1,1,2,1,1,1,0,0,2,0,0,0,0,2,0,0],
      [2,2,2,2,2,2,2,2,1,0,0,2,0,0,1,0,0,2,0,0,0,0,2,0,0],
      [1,1,2,0,0,0,0,0,1,0,0,2,0,0,1,0,0,2,2,2,2,2,2,0,0],
      [1,1,2,0,0,0,0,0,1,1,1,1,1,1,1,0,0,0,0,2,2,0,0,0,0],
      [1,1,2,0,0,0,0,0,0,0,0,0,0,0,0,0,0,0,0,0,0,0,0,0,0]],
    "explored":[
      [0,0,0,0,0,0,0,0,0,0,0,0,0,0,0,0,0,0,0,0,0,0,0,0,0],
      [0,0,0,0,0,0,0,0,0,0,0,0,0,0,0,0,0,0,0,0,0,0,0,0,0],
      [0,0,0,0,0,0,0,0,0,0,0,0,0,0,0,0,0,0,0,0,0,0,0,0,0],
      [0,0,0,0,0,0,0,0,0,0,0,0,0,0,0,0,0,0,0,0,0,0,0,0,0],
      [0,0,0,0,0,0,0,0,0,0,0,0,0,0,0,0,0,0,0,0,0,0,0,0,0],
      [0,0,0,0,0,0,0,0,0,0,0,0,0,0,0,0,0,0,0,0,0,0,0,0,0],
      [0,0,0,0,0,0,0,0,0,0,0,0,0,0,0,0,0,0,0,0,0,0,0,0,0],
      [0,0,0,0,0,0,0,0,0,0,0,0,0,0,0,0,0,0,0,0,0,0,0,0,0],
      [0,0,0,0,0,0,0,0,0,0,0,0,0,0,0,0,0,0,0,0,0,0,0,0,0],
      [0,0,0,0,0,0,0,0,0,0,0,0,0,0,0,0,0,0,0,0,0,0,0,0,0],
      [0,0,0,0,0,0,0,0,0,0,0,0,0,0,0,0,0,0,0,0,0,0,0,0,0],
      [0,0,0,0,0,0,0,0,0,0,0,0,0,0,0,0,0,0,0,0,0,0,0,0,0],
      [0,0,0,0,0,0,0,0,0,0,0,0,0,0,0,0,0,0,0,0,0,0,0,0,0],
      [0,0,0,0,0,0,0,0,0,0,0,0,0,0,0,0,0,0,0,0,0,0,0,0,0],
      [0,0,0,0,0,0,0,0,0,0,0,0,0,0,0,0,0,0,0,0,0,0,0,0,0],
      [0,0,0,0,0,0,0,0,0,0,0,0,0,0,0,0,0,0,0,0,0,0,0,0,0],
      [0,0,0,0,0,0,0,0,0,0,0,0,0,0,0,0,0,0,0,0,0,0,2,0,0],
      [1,1,1,1,1,0,0,0,0,0,0,0,0,0,0,0,0,0,0,0,0,0,0,0,0],
      [1,1,1,1,1,0,0,0,0,0,0,0,0,0,0,0,0,0,0,0,0,0,0,0,0],
      [1,1,1,1,1,0,0,0,0,0,0,0,0,0,0,0,0,0,0,0,0,0,0,0,0]]
  },
  "resource_structures":[
    {"square_number":{"x":3,"y":15},"owner":-1,"type":0},
    {"square_number":{"x":4,"y":7},"owner":-1,"type":1},
    {"square_number":{"x":16,"y":8},"owner":-1,"type":2}
  ],
  "resource_piles":[
    {"square_number":{"x":6,"y":3},"amount":10,"type":1},
    {"square_number":{"x":19,"y":1},"amount":10,"type":1},
    {"square_number":{"x":20,"y":1},"amount":10,"type":1},
    {"square_number":{"x":11,"y":2},"amount":5,"type":2},
    {"square_number":{"x":22,"y":8},"amount":8,"type":2},
    {"square_number":{"x":12,"y":8},"amount":500,"type":0},
    {"square_number":{"x":11,"y":8},"amount":300,"type":0}
  ],
  "players":[
    {
      "id":1,
      "gold":500,
      "wood":2,
      "stone":2,
      "color":1,
      "human":true,
      "heroes":[
        {
          "defense":0,
          "attack":0,
          "mobility":7,
          "square_number":{"x":2,"y":0},
          "owner":1,
          "remaining_movement":5,
          "type":1,
          "cpu":false,
          "stacks":[
            {"type":11,"number":10},
            {"type":12,"number":10},
            {"type":11,"number":10}
          ]
        }
      ]
    }
  ],
  "map_objects":[
      [4,4,4,4,4,4,4,4,4,4,4,4,4,4,4,0,0,7,7,7,7,7,7,7,1],
      [0,0,0,0,0,0,0,0,0,0,0,0,0,0,0,0,0,7,0,0,0,0,0,7,1],
      [0,0,4,4,4,4,4,0,0,0,2,2,0,0,1,1,0,7,0,0,0,0,0,7,1],
      [0,0,4,0,0,0,4,0,0,0,2,2,0,0,0,0,1,7,0,0,0,0,0,7,1],
      [0,0,4,0,0,0,4,0,0,0,0,0,0,0,1,0,0,7,7,7,0,7,7,7,1],
      [0,0,4,0,0,0,0,0,0,0,0,0,0,0,0,0,0,0,0,7,0,7,0,0,0],
      [0,0,0,0,0,0,0,0,0,0,0,0,0,0,0,0,0,0,0,0,0,0,0,0,0],
      [0,0,0,0,0,0,0,0,0,0,0,0,0,0,0,0,0,0,0,0,0,0,0,0,0],
      [0,0,0,0,0,0,0,0,0,0,0,0,0,0,1,1,1,1,1,1,1,1,0,0,0],
      [1,1,1,1,1,1,1,1,1,1,1,1,1,1,1,1,1,1,6,1,1,1,0,0,0],
      [1,1,1,1,1,1,1,1,1,1,1,1,1,1,1,1,1,1,0,6,1,1,0,0,0],
      [1,1,1,1,0,0,0,0,0,0,0,0,0,1,1,6,0,0,0,6,6,1,0,0,0],
      [1,1,0,0,0,0,0,0,3,3,3,3,3,1,1,6,6,0,6,6,6,1,0,0,0],
      [1,1,0,0,0,0,0,0,3,3,3,3,3,1,1,6,6,0,6,6,6,1,0,0,0],
      [1,0,0,0,0,0,0,0,0,0,0,0,0,0,0,0,0,0,0,0,0,0,0,0,0],
      [0,0,0,0,0,0,0,0,0,0,0,0,0,0,0,6,6,0,0,0,0,0,0,0,0],
      [0,0,0,0,0,0,0,0,0,3,6,0,6,3,0,0,0,0,1,1,1,1,0,0,0],
      [0,0,0,0,0,0,0,0,0,3,3,0,3,3,0,1,1,0,0,0,0,0,0,0,0],
      [0,0,0,1,1,1,1,1,0,0,0,0,0,0,0,1,1,0,0,0,0,0,0,0,0],
      [0,0,0,1,1,1,1,1,1,1,1,1,1,1,1,1,1,0,0,0,0,0,0,0,0]
    ],
  "map_creatures":[
    {
      "stacks":[
        {"type":11,"number":10},
        {"type":11,"number":6}
      ],
      "square_number":{"x":10,"y":8},
      "type":11
    },
    {
      "stacks":[
        {"type":12,"number":5},
        {"type":12,"number":10},
        {"type":12,"number":5}
      ],
      "square_number":{"x":5,"y":14},
      "type":12
    }
  ],
  "map_castles":[
    {
      "id": 1,
      "type": 0,
      "owner": 0,
      "square_number":{"x":18,"y":16},
      "stacks":[],
      "buildings_levels": [0,-1,0,1,-1,0,-1,-1],
      "number_units": [2,0,0,0,0]
    }
  ]
}
